10
30
wwwwwwwwwwwwwwwwwwwwwwwwwwwwww
w                            w
w                            w
w   ww                       w
w                            w
w       ww                   w
w  P        ww               w
w                            w
w                            w
wwwwwwwwwwwwwwwwwwwwwwwwwwwwww